A	AH
A(2)	EY
ARE	AA R
ARE(2)	ER
DO	D UW
EAT?	IY T
HUNGRY?	HH AH N G R IY
LIKE	L AY K
MOVIE?	M UW V IY
TO	T UW
TO(2)	T IH
TO(3)	T AH
WANT	W AA N T
WANT(2)	W AO N T
WATCH	W AA CH
WATCH(2)	W AO CH
WHAT	W AH T
WHAT(2)	HH W AH T
WOULD	W UH D
YOU	Y UW
